5 5
1 1 1 1 1
1 2 1 7 1
1 1 4 1 1
1 1 1 11 01
1 6 1 01 01