5 5
1 1 1 1 1
1 8 1 1 1
1 2 3 1 1
1 4 1 11 01
1 1 1 01 01
